  +------------------------------------------------------------------+
  |                                                                  |
  |                                 6                                |
  |      +----------------------------------------------------+      |
  |      |                                                    |      |
  |      +----------------------------------------------------+      |
  |                                 5                                |
  |      +----------------------------------------------------+      |
  |      |                                                    |      |
  |      +----------------------------------------------------+      |
  |                                 4                                |
  |      +----------------------------------------------------+      |
  |      |                                                    |      |
  |      +----------------------------------------------------+      |
  |                                 3                                |
  |      +----------------------------------------------------+      |
  |      |                                                    |      |
  |      +----------------------------------------------------+      |
  |                                 2                                |
  |      +----------------------------------------------------+      |
  |      |                                                    |      |
  |      +----------------------------------------------------+      |
  |                                 1                                |
  +      ------------------------------------------------------------+
  |      | 
  |  0   | 
  |      | 
  |      | 



小车样式 (与 main.c 一致):
    Vx^+ (前)
    |
  B   |   C
    |
  ------+-------> Vy+ (右)
    |
  A   |   D
    |
